####################
#...............##
#.#.#.#.#.#.##########
#.#.#.#.#.#.#######
#.#########.##############
#.#########.##############
#.#.........##############
#.#.########################
#.#.#.#.#.#*################
#.#.#.#.#.#.###############
#.#.............#######
@.#######################