#@##############
#.........+#####
#.##############
#.....%........#
#.#.###.##..####
#.#.###.##....*#
#.#.###.##..####
#.........%....#
################
################
################
################
################