##.###.###.###@#
#..............##
#.###############
#.....+.......%##
###.#.#...####.#
##############.###
#..............##
#.#################
#.##...###########
#.##.#.##############
#.##.#.############
#....#.......*##
###############