#######@########
#######.########
#######.########
#....%.....+...#
#............%.#
#..%...........#
####.......%####
#######*#######
################
################
################
################
################
################
