####################
#%..............##
#.#+#.#.#.#.##########
#.#.#.#.#.#.#######
#.#########.##############
#.#########.##############
#.#.........#..###########
#.#.########################
#.#.#.#.#.#*################
#.#.#.#.#.#.###############
#.#%............#######
@.#######################